#segment=units
Zenit=grp_aa_turret.cfg#aa_turret.cfg
Airplant=grp_air_plant.cfg#air_plant.cfg
Airtrans=grp_air_transport.cfg#air_transport.cfg
alnasgun=grp_alien_assault_gun.cfg#alien_assault_gun.cfg
alnplane=grp_alien_plane.cfg#alien_plane.cfg
alntank=grp_alien_tank.cfg#alien_tank.cfg
Arturret=grp_artillery_turret.cfg#artillery_turret.cfg
Asgun=grp_assault_gun.cfg#assault_gun.cfg
Awac=grp_awac.cfg#awac.cfg
barrak=grp_barracks.cfg#barracks.cfg
Conblock=grp_block.cfg#block.cfg
Bomber=grp_bomber.cfg#bomber.cfg
Bridge=grp_bridge.cfg#bridge.cfg
Dozer=grp_bulldozer.cfg#bulldozer.cfg
Seacargo=grp_cargo_ship.cfg#cargo_ship.cfg
Conn=grp_connector.cfg#connector.cfg
Constructor=grp_constructor.cfg#constructor.cfg
Corvette=grp_corvette.cfg#corvette.cfg
Crawler=grp_crawler.cfg#crawler.cfg
Store=grp_depot.cfg#depot.cfg
Dock=grp_dock.cfg#dock.cfg
Ecosphere=grp_ecosphere.cfg#ecosphere.cfg
Engineer=grp_engineer.cfg#engineer.cfg
Escort=grp_escort.cfg#escort.cfg
Seafuel=grp_fuel_ship.cfg#fuel_ship.cfg
Fuelstore=grp_fuel_store.cfg#fuel_store.cfg
Fueltruck=grp_fuel_truck.cfg#fuel_truck.cfg
gref=grp_gold_refinery.cfg#gold_refinery.cfg
Goldstore=grp_gold_store.cfg#gold_store.cfg
GTruck=grp_gold_truck.cfg#gold_truck.cfg
Gunboat=grp_gun_boat.cfg#gun_boat.cfg
turret=grp_gun_turret.cfg#gun_turret.cfg
Habitat=grp_habitat.cfg#habitat.cfg
Hang=grp_hangar.cfg#hangar.cfg
Hvplant=grp_heavy_plant.cfg#heavy_plant.cfg
infantry=grp_infantry.cfg#infantry.cfg
Infil=grp_infiltrator.cfg#infiltrator.cfg
Inter=grp_interceptor.cfg#interceptor.cfg
juger=grp_juggernaut.cfg#juggernaut.cfg
landmine=grp_land_mine.cfg#land_mine.cfg
landpad=grp_landing_pad.cfg#landing_pad.cfg
Lightplant=grp_light_plant.cfg#light_plant.cfg
Matstore=grp_material_store.cfg#material_store.cfg
Truck=grp_material_truck.cfg#material_truck.cfg
Miner=grp_minelayer.cfg#minelayer.cfg
Mining=grp_mining_station.cfg#mining_station.cfg
misturret=grp_missile_turret.cfg#missile_turret.cfg
Aagunm=grp_mobile_aa_gun.cfg#mobile_aa_gun.cfg
pcan=grp_personnel_carrier.cfg#personnel_carrier.cfg
Powergen=grp_power_generator.cfg#power_generator.cfg
Powerpl=grp_power_plant.cfg#power_plant.cfg
Radar=grp_radar.cfg#radar.cfg
Repair=grp_repair_unit.cfg#repair_unit.cfg
research=grp_research_lab.cfg#research_lab.cfg
Road=grp_road.cfg#road.cfg
Rokcr=grp_rocket_boat.cfg#rocket_boat.cfg
Rocket=grp_rocketter.cfg#rocketter.cfg
Scanner=grp_scanner.cfg#scanner.cfg
Scout=grp_scout.cfg#scout.cfg
seamine=grp_sea_mine.cfg#sea_mine.cfg
seaminelay=grp_sea_minelayer.cfg#sea_minelayer.cfg
Plat=grp_sea_platform.cfg#sea_platform.cfg
Seatrans=grp_sea_transport.cfg#sea_transport.cfg
Shipyard=grp_shipyard.cfg#shipyard.cfg
sub=grp_submarine.cfg#submarine.cfg
Surveyor=grp_surveyor.cfg#surveyor.cfg
Tank=grp_tank.cfg#tank.cfg
pehplant=grp_training_hall.cfg#training_hall.cfg
seamine=grp_sea_mine.cfg#sea_mine.cfg
#segment=clans
#segment=configs